R 1920 1080

NO ./textures/text1.xpm
SO ./textures/text4.xpm
WE ./textures/text3.xpm
EA ./textures/text2.xpm

S ./textures/creeper.xpm
F 90,0,22
C 200,105,100


        1111111111111111111111111
        1000000000110000000000001
        1011000001110000001000001
        1001000000000000E00001001
111111111011000001110000000000001
100000000011000001110111110111111
11110111111111011100000010001
11110111111111011101010010001
11000000110101011100000010001
10001000000000001100000010001
10000000000000001101010000001
1100000111010101111101111000111
11110111 1110101 101111010001
11111111 1111111 111111111111
