EA ./textures/text2.xpm
NO ./textures/text1.xpm
SO ./textures/text4.xpm
WE ./textures/text3.xpm

F 100,200,230
C 200,105, 1

1111111
101N101
1111111
