EA ./textures/text2.xpm
NO ./textures/text1.xpm
SO ./textures/text4.xpm
WE ./textures/text3.xpm

F 100,200,230
C 200,105, 1

        1111111111111111111111111
        100000000001000000000N011
        101100 00          011
        100000000000000000010011
111111111011000001110000000000001
10000000001100000111011011011111
11110111111111011100000010001
11110111111111011101010010001
11000000110101011100000010001
10001000000000001100000010001
10000000000000001101010000001
1100000111010101111101111000111
11110111111101011101111010001
11111111111111111111111111111