NO ./textures/text1.xpm
SO ./textures/text4.xpm
WE ./textures/text3.xpm
EA ./textures/text2.xpm


F 100, 20, 0
C 200, 105, 1  



11111111111111111111111111111111111111111111111111111111111111111111111111111111111
100001    100000000000000000000000000000000000000000000000000000001
100001    1000000000000000000000000000000000000000000000000000000001111111
100001    100000000000000000000000000000111110000000000000000000000000001
111111    11000000000000000000000000000000100000000000000000000000000011
          111111111111111111111111111111111111111111111111111111111111111
111111111111111111111111111111111111111111111111111111111111111111111111
11111111111000000000000000000000000010000000000000000000000000001
100000000000000100000000000000000000000000010000000000000000011101111111
100000000000000000000000000000000010000000010000000000000000000000000001
100000000000000000000001001000000100000000000100000000001111000000000001
100000000000000000000001010011000000000000010000000000001000000000000001
100000000000000111111111100101100000000000000000000000001001000000000001
100000000000000100000000001000110000000000000000000000001000000000001001
100000000000000100011111000100011001000000N00010000001001000000100000001
100000000000000110010000000000000001000000010000000000000000000100000001
100000000000000000000000000000000000000000010000000001000001000100000001
100000000000000000000000000010000100000000010000000000000000000000000001
100000000000000000100000000000000000000000000000000000000000111000000001
100000000000000000100000000000000000000000011110000000000000000000000001
100000000000000000000000000000000000000000000000000000000000000100000001
100000000000011100000000000000000000000000000000000001000000000000000001
100000000000000100000000011000000000111100000000000000000000000100000001
100000000000000100100000000000000000000100000000000010000000000100000001
100000000000000100000000000000000000000100000000000000000011111100000001
100000000000000000000000000000000000000000000000000000000000000000000001
100000000000000000000010000000000011011000000100000110000000000000000001
100001000000000000000000000000000000001000000000000000000000000000000001
100001000000000000000000000000000000001000000000000000000000000000000001
100001000000000000000000000000000000001000000000000000000100000000000001
100000001110000000100000000000000001111000001000000000000000000000000001
100000000000000000000000000000000000000000000000000000000001000000000001
100000000000000000000000000000000000000000000000000000001111000000000001
100000001110000100000000000000000000100000000000000000000001000000000001
100000000000000000000000000000000001100000000000000000000001000000000001
100000000000000000000001001000000100000000000100000000000001111000000001
100000000000000000000001010011000000000000010000000000000001000000000001
100000000000000111111111100101100000000000000000000000000000000000000001
100000000000000100000000001000110000000000000000000000000000000000001001
100000000000000100011111000100011001000000000010000001000000000100000001
100000000000000110010000000000000001000000010000000000000000000100000001
100000000000000000000000000000000000000000010000000001000000000100000001
111111111111111111111111111111111111111111111111111111111111111111111111