EA ./textures/text2.xpm
NO ./textures/text1.xpm
SO ./textures/text4.xpm
WE ./textures/text3.xpm

F 100,200,230
C 200,105, 1

        1111111111111111111111111
        100000000001000000000N011
        1011000000000000000000011
        100000000000000000010011
11111111101100000111000000000001111
1000000000110000111011111011111
11110111111111111100000010001
11110111111111 11101010010001
11000000110101111100000010001
10001000000000001100000010001
10000000000000001101010000001
1100000111010101111101111000111
11110111 1110101 101111010001
11111111 1111111 111111111111