1111111111111
1000001100011
1111100100111
1000001110001
100E000100001
1000000000001
1111111111111